W W W W W W W W W W
W D C O C O O O O W
W O O O O O O C O W
W O O O O O O O O W
W O O O O O O O O W
W O O O O O O O O W
W O O O O O O O O W
W O O O O O O O O W
W O O O O O O O D W
W W W W W W W W W W